Orth	Phon
b 	b
ch 	tʃ
d 	d
f 	f
g 	ɡ
gb 	ɡ͡b
gb	~ɠ͡ɓ
gh 	ɣ
gw 	ɡʷ
h 	ɦ
j 	dʒ
k 	k
kp 	k͡p
kp 	ƙ͡ƥ
kw 	kʷ
l 	l
m 	m
n 	n
ṅ 	ŋ
nw 	ŋʷ
ny 	ɲ
p 	p
r 	ɹ
s 	s
sh 	ʃ
t 	t
v 	v
w 	w
y 	j
z 	z
ọọ	ɔ̙ː
aa	aː
ee	eː
ii	iː
ịị 	ɪ̙ː
uu	uː
ʊ̙ʊ̙	ʊ̙ː
a 	a
e 	e
i 	i
ị 	ɪ̙
o 	o
ọ 	ɔ̙
u 	u
ụ 	ʊ̙
